11111111111111111111111111111111
11111111111111111111111111111111
11111111111111111111111111111111
11111111111111111111111111111111
11111111111111111111111111111111
11111111111111111111111111111111
11111111111111111111111111111111
11111111111111111111111111111111
11111111111111111111111111111111
11111111111111001000000001100011
11111111111111000000000000000011
11111111100000000000000000000000
11111111100000000000000000000000
11111111100000000000000000000000
11111110000000000000000000000111
11111110000000000000000000001111
11111100000000000000000000011111
11111111100000000000000000011111
00000000000000000000000000000000
00000000000000000000000000000000