11111111111111111111111111111111
11111111111111111111111111111111
11111111111111111111111111111111
11111111111111111111111111111111
11111111111111111111111111111111
11111111111111111111111111111111
11111111111111111111111111111111
11111111111111111111111111111111
11111111111111111111111111111111
11011111111111111000111111111111
00000111111000000000000011111111
00000000000000000000000000111111
00000000000000000000000000111111
01100000000000000000000000001111
11110000000000000000000000001111
11111000000000000000000000000000
11111000000000000000000000000000
11111100000000000000000000001111