11111110000000000000000001111111
11111110000000000000000001111111
11111110000000111100000001111111
11110000000011111111001111111111
11110000000111110111101111111111
11110000001111100111100011111111
00000000011111000111100000111111
00000000011110000111100000000000
00000000011110000111110000000000
00000000111110000111000000000000
00000000111110000000000000000000
00000000000000000000000000000000
00000000000000000000000000001100
00111000000000000000000000001100
11111100000000000000000000000000
11111100000001111111000000000000
11111100011111111111000000000000
11111100011111111111100000000000