11111110000000000000000000000000
11111110000000000000000000000000
11111100000000000000000000000011
11111100000110000000000000000111
11111000001111000000000000000111
10000000111111110000000000000010
00001111111111111110000001011000
00011111111111111000000001111000
00001111111111000000000001111100
00000111111100000000000000000000
00000000000000000000000000000000
00000000000000000000000000000000
00000000000000000000000000000000
00000000000000000000000000000000
00000000000000000000000001111111
00000000000000000000000111111111
00000000000000000011111111111111
00000000000000000011111111111111