11111111111111111111111111111111
11111111111111111111111111111111
11111111111111111111111111111111
11111111111111111111111111111111
11111111111111111111111111111111
00000111111111111111111111111111
00000111111111111111111111111111
00011111111111111111111111111111
00011111111111110000000111111111
00111111111111100000000111111111
00111011110000000000000000011111
00000010000000000000000001111111
00000000000000000000000111111111
00000000000000000111101111111111
00000000000000011111111111111111
00000000000000111111111111111111
00000000000000011111111111111111
00000000000011111111111111111111