11111111111111111111111111111111
11111111111111111111111111111111
11111111111111111111111111111111
11111111111111111111111111111111
11111111111111111111111111111111
11111111111111111111111111111111
11111111111111111111111111111111
11111111111111111111111111111111
11111111111111111111111111111111
11111111111111111111111111111111
11111111100111111111111111111111
11111100000000000000110000000000
11111100000000000000000000000000
11111000000000000000000000000000
11111000000000000000000001000000
00000000000000000000000001000000
00000000000000000000000000000000
11111111000000000000000000000011