11111111111111111111111111111111
11111111111111111111111111111111
11111111111111111111111111111111
11111111111111111111111111111111
11111111111111111111111111111111
11111111111111111111111111111111
11111111111111111111111111111111
11111111111111111111222211111111
11111001000000111111222211111111
11111001000000000030222211111111
11100000000000000000000211111111
11100000000000000000000011111111
00000000000000000000000000111111
00000000000000000000000000000111
00000000000000000000000000000000
01100000000000000000011000000000
11100000000000000000111110000011
11110000000000000011111111001111
