11111111111111111111111111111111
11111111111111111111111111111111
11111111111111111111111111111111
11111111111111111111111111111111
11111111111111111111111111111111
11111111111111111111111111111111
11111111111111111111111111111111
11111111111000000000011111111111
11111111100000000000000111111111
11111100000000000000000011111111
11111100000000000000000000111111
11111100000000000000000011111111
00000000000000000000110011111111
00000000000000000000111111111111
00000000000000000000011111111111
00000000000000000000001111111111
11100000000000000000001111111111
11111000000000000000011111111111