11110000111111111110000000000011
11110011111111110000000000000011
11111111111111100000000000000111
11111111111111111111000000000111
11111111111111111000000000000000
11111111111111100000000000000000
11111111111111111100000000000000
11111111111111111100000000000000
11111111111111111111100000000000
11111111111111111111111000000000
11111111111111111111111000000000
11111111111111111111110000000000
11111111111111000000000000000000
11111111111000000000000000000000
11111111111000000000000000000001
11111111111110000000000000000011
11111111111110000000000000000011
11111111111110000000000000000011