11111111111111111111111111111111
11111111111111111111111111111111
11111111111111111111111111111111
11111111111111111111111111111111
11111111111110000000001111111111
11111111111100000000000001111111
11111111111100000000000111111111
11111111111100000000000111111111
11111100000000000110100111111111
11111000000000000111111111111111
11111100000000000001111111111111
11111000000000000001111111111111
11111100000000000000111111111111
11110000000000000000001111111111
11000000110000000000000111111111
00000000110000000000000001111111
00000000000000000000000000000111
00000000000000000000000000000111