00000000000000011111111111111111
00000000000000001111111111111111
00000000000000001111111111111111
00000000000000011111011111111111
00000000000000011111111111111111
00000000000000111111111111111111
00000000000000111111111111111111
00000000000000111111111111111111
00000111000000000011111111111111
00001111111100000000111111111111
11111001111110000000001111111111
11111000111111000000000011000000
11110000001111000000000000000110
00010000000000000000000000000000
00000000000000000000000000000000
11100000000101110110000000000000
11110000000111001100000000000000
11110000000000000000000000000000