00000000000001111111111111111111
00000000000001111111111111111111
00000000000001111111111111111111
11000000000000011111111111111111
11000000000000111111111111111111
11100000000000111111111111111111
11100000000000111111111111111111
11110000011000111111111111111111
11110000011101111111111111111111
11110000111001111111111111111110
00000000000000001111111110000000
00000000000000000011111100000000
00000000000000000000000000000000
00000000000000000011111110000000
00000000000000000111111111110000
00000000000000001111111111111111
00000000000000011111111111111111
00000000000001111111111111111111