11111111000000000000001100001111
11111110000000000000011111111111
11111100000000000000111111111111
11110000000000000011111111111111
00000000000000000111111111111111
00000000000000111111111111111111
00000000000000111111111111111111
00000000000000111111111111111111
00000000110000111111111111111111
00000001111100111111111111111111
00000000000000000111111111111111
00000000000000000001111111000001
00000000000000000000011000000000
00000000000000000000000000000000
11100000000000000000000000000000
11110000000000000000000000000011
11111100000000000000000000011111
11111110000000000000000000011111