11110000000000000011111111111111
11111000000000000001111111111111
11111100000000000011111111111111
11111100000000000011111111111111
11111111000000000011111111111111
11111111000000000111111111111111
11111111000000000111111111111111
11111100000000000111111111111111
11000000000000000111111111111111
10000000000001000111111111111111
10000000000011000011111111111111
00000000000000000000111111111111
00000000000000000000001111111111
11000000000000000000000111111111
11111000000000000000000000000111
11111000000000000000000000000000
11111100000000000000000000000000
11111111111100000000000000000000