11111000000000000000011111111111
11111000000000000000001111111111
11111111000000000000000001111111
11111111000000000000000000011111
11111100000000000000000000011111
11111000000000000000000000001111
11111000000000000000000000001111
11111000000000000000000000001111
11111011100000000001111000001111
11111111100000000111111000000111
11111111110000000111111110100000
11111111000000000011111111110000
11111000000000000000000100000000
11100000000000000000000000000000
11000000000000000000000000000000
10000000000000000000000000001000
00000000000000000000000000111000
00000000000000000000000000000000