11111111111111111111111111111111
11111111111111111111111111111111
11111111111111111111111111111111
11111111111111111111111111111111
11111111111111111111111111111111
11111111111111111111111111111111
11111111111111111111111111111111
11111111111111111111111111111111
11110000001111111111111111111111
10000000000011111111111111111111
00000000000000000000001111111111
00000000000000111100011111111111
00000000000000001110000011111111
00000000000000000000000000011111
11111000000000000000000000011111
11111000000000000000000000111111
11111000000000000000000000110111
11111000000000000000000111111111