11111111111111100000000000000000
11111111111111110000000000000000
11111111111111111110000000000000
11111111111111111111111100000000
11111111111111111111111111000000
11110111111111111111111111000000
11111111111111111111111110000000
11111000111111111111111100000000
11000000011111111111111000000000
11000000000111111111111000000000
11111111000001111111110000000000
11111111100000110000000000000000
11111111110000000000000000000000
11111111111100000000000000000000
11111111111000000000000000000000
11111111000000000000000000000000
11111100000000000000000000000000
11111100000000000000000000000000