11111111111111000000000000000000
01111111111111000000000000000000
01111111111111000000000000000000
00111111111111000000000000000000
00111111111111000000000000000000
00111111111111000000000000011111
00011111111111000000011111111111
00011111111111100000012222111111
00011111111111000000012222111111
00111111111110000003012222111111
01111111111100000000000002111111
00000000000000000000000000011111
00000000000000000000000000000000
00000000000000000000000000000000
00000000000000000000000000000000
11000000000000000000000000000000
11000000000000000000000000000011
11100000000000000000000000000011