11100000000001111111111111111111
11100000000011111111111111111111
00000000000111111111111111111111
00000000001111111111111111111111
00000000001111111111111111111111
11000000011111111111111111111111
11100000111111111111111111111111
11100001111111111111111111111111
11100001111111111111111111111111
11110000111111111111111111111111
11100000011111111100000111111100
00000000000111100000000001110000
00000000000000000000000000000000
00000000000000000000000000000000
00000000000000000000111111111111
00000000000000000000111111111111
00000000000000000011000001111111
00000000000000011111100000011111