11111111000000000000111100011111
11111111000000000011111110011111
11111110000000000111111111111111
11111111000000000111111111111100
11111111000000001111111111110000
11111100000000001111111111110000
11111100000000001111111111100000
11111000001100111011111111111000
11111000001100110011111111111000
11111000011100000100111111111000
11100000010000300110000111000000
00000000000000000011000000000000
00000000000000000011000000000000
00000000011000000000000000000000
00000111111110000000000000011000
00001111111110000000000000000000
00011111111111100000000000000011
00111111111111100000000000001111