11111111111111000000000000000000
11111111111111111000000000000001
11111111111111111000000000000011
11111111111111110000000000000111
11111111111111110000000000000111
11111111111111110000000000000111
11111111111111110000000000000001
11111111111111110001110000000011
11111111111111100011110000000111
11111111111100001110000000000111
00001111100110000000000000011111
00000111000110000000000011111111
00000000000110001000110001110011
00000000000000011100000000000000
00000000000000000000000000000000
11100000000000000000000000000000
11110000000000000000000000000000
11110000000000000000000000000000