11110000000000000000000000000000
11110000000000000000000000000000
11111000000000000011110000000001
11111110000000001111111000000011
11111111100000011111111110000011
11111111100000111111111111000111
11111000000001111111111111100111
11011000000011111111111111100111
11000000000011111111111111100111
11000000000001111111111111100111
11110000000001111111111111100000
11111000000000111111111111100000
11110000000000111111111111100000
00000000000000111111111111100000
00000000000000001111111110000000
00000000000000000000000000000000
00000000000000000000000000000111
00000000000000000000000000001111