00000011111111111111111111111111
00000011111111111111111111111111
00000011111111111111111111111111
00000011111111101111111111111111
00000011111000000111111111111111
10000011110000000111111111111111
10000000000000001111111111111111
11000000000001111111111111111111
10000000000001111111111111111111
00000000000000011111111111111111
00000000000000000000111111111111
00000000000111000000111111111111
00000000001111000000000001111111
00000000001111100000000000111111
00110000001111111100000000111111
00111000000000111111111111111111
11111000000011111111111111111111
11111000001111111111111111111111
