00000000000000000000000000000000
00000000000000000000000000000000
00000000000000000000000000000111
00000000000000000000000000001111
00000000000000000000000000000111
00000000000000000000000000000011
11000000000000000000000000000011
11111000000011111100000000000000
11111111111111111111100000000000
11111111111111111111100000000000
11111111111111111110000000000000
11111111111111111100000000000001
11111111111100010000000000011111
11111111111110000000000011111111
11111111111110000000001011111111
11111111111111100000001111111111
11111111000000000000000111111111
11111000000000000000001111111111