00000000000001111111100000000000
00000000000001111111110000000000
00000000000001111111111000000000
00000000000000111111111110000000
00000000000000111111111111000000
00000000000000111111111111110000
00000000000111111111111111110000
00000000000111111111111111110000
11111100000111111111111111110000
11111111100011111111111111110000
11111111000000001111111111110000
00000000000000000001111111100001
00000000000000000000111100100011
01100000000000000000000000000011
11111110000000000000000000000011
11111111111110000000000000000011
11111111111110000001100000000011
11111111111110000111111100000011