11111111111111100000000000000000
11111111111111100000000000000000
11111111111111100000000000000000
00011111111111100000000000000000
00011111111111100000000000000000
00011111111111100000000000000001
00011111111111100000000000000111
00011111111111100000000000001111
00011111111111110000000000001111
00011111111111110000000000011111
00111111111111110000000000111111
00111111111100000000011111111111
00000011110000000000000111111111
00000000000000000000000000011100
00000000000000000000000000000000
00000000000000110000000000000000
00000000000000110000000000000000
00000000000000000000000000000000