00000000000000000000000000001111
00000000000000001111100000011111
00000000000000111111111100011111
00000000011111111111111111111111
11111100011111111111111111111111
11100000011111111111111111111111
00000001111111111111111111111111
10100001111111111111111111111110
11100000111111111111111111111100
11111000111111111111111111111100
11000001111111111100001111111000
10000001111111100000000011100000
00000000001101000000000000000000
00000000000000000000000000000000
00000000000000000000000000000000
00000000000000000000000000111100
00000000000000000000000000001000
00000000000000000000000000000000