11100000000000000000000001111111
11110110000000000000001111111111
11110110000000000001111111111111
11100000000000000001111111111111
00000000000000000001111111111111
00000000000000000011111111111111
00000000000000000111111111111111
00000000000111111111111111111111
00000000011111111111111111111111
00000000011111111111111111111111
00000000000000000000111111111111
11000000000000000000110000011111
11100000000000000000000000011111
11100000000000000000000000001111
10000000000000000000000000011111
00000000000000000000000000001111
00000000000000000000000000000111
00000000000000000000000000011111