11111100000000000000011111111111
11111000000000000000001111111111
11111111000000000000000000000111
11111111111110000000000000000111
11111111111111100000000000000111
11111111111111111100000000000000
11111111111111111111000000000000
11111111111100000000000000000000
11111111110000000000000000000000
11111111100000000000000000000011
11100000000000000000000000001111
11100000000000000000000000001111
11111100000000000000000000001111
11111100000000000000000000111111
11111111000000000000000000111111
11111111110000000000000000000011
11111111110000000000000000000000
11111111110000000000000000000000