00000000000000000000000000111111
00000000000000000000011111111111
11111100000000000111111111111111
11111111000000000111111111111111
11111110000000000111111111111111
00001100000000000011001111111111
00000000000000000011001111111111
00000000000000000000011111111111
00000000000110000001111111111111
11111100000110011111111111111111
11111111000001111111111111110011
11111111111111111111111111000000
11111111111111111111111111100000
11111111111111111111111111111111
11111111111111111111111111111111
11111111111111111111111111111111
00111101111111111111111111111111
00000000011111111111111111111111