11111111111000001111111110000000
11111111110000001111111110000000
11111111110000011111111110000000
11111111111100011111111110000000
11111111111111001111111111100000
11111111111111000111111111111000
11111111111100001111111111111100
11111111111000001111111111111110
11111111100000001111111111111100
11111111100000000111111111111110
00111111111100000011111111111111
00011111111111000001111111111111
00111111111111110011111111111011
11111111111111111111111111100011
11111111111111111111111111110000
11111111111111111111111111100000
11111111111111111111111110000000
11111111111111111111100000000000