00000000000000000000000000000000
01111100000000000000000000000000
01111110000000000000000000000000
00001110000000000000000000000000
00000000000000000000000111100000
00000000000000000000000111110011
00000000000000000000000000110011
00000001100000000000000000000000
11100001000000000000000000000000
11110001000000000000111011100000
11111000000000000001111111000000
11110000000000011101111111000000
11000000000000000000011000000000
10000000100000000000000000011110
00000001110000000000000000000000
00000011110000000000000000000000
00000111111000000000000000000000
0000011111100000000000000000000