00000000000000000111110000000000
00000000000000011111111000000000
00000000000000111111111100000111
01111100000000111111111110000111
01111100000000111111111111000111
00000000000001111111111111000011
00000000000001111111111111100001
00000000000000000011111111100000
00000000000000000000001111110000
00000000000000000000000111100000
00000000000000000000000000100000
00000000000000000000000000000000
00110000000000000000000000000000
00010000001100000000000011110000
00010000001100000000000111111100
00000000000000000000000011111110
00000000000000000000000000111110
00000000000000000000000000000000