11110000000000000000000000001111
11110000000000000000000111111111
11110110100000000000011111111111
11100111100000000001111111111111
11000000000001111111111111111111
11000000000111111111111111111111
10000000000111111111111111111111
00000000001111111111111111111111
00000000001111111111111111111111
00000000000001111111111111111111
00000111000001111111111100111111
01100111000001111101110000111111
01110110000000001000000000111111
00000000000000000000000000110111
00000000000000000000000000000000
00000000000000000000000000000000
00000000000000000000000000000000
00000000000000000000000000000000