11111111111111111111111111111111
11111111111111111111111111111111
11111111111111111111111111111111
11111111111111111111111111111111
11111111111111111111111111111111
11111111111111111111111111111111
11111111111111111111111111111111
11111111111111111111111111111111
11111111111100001111111111111111
11111111111000001111111111110000
11111111000000000001111111110000
00001110000000000000000011110000
10000000000000000000000000000000
11100000000000000000000000000001
11111111000000000000000000000111
11111111111110000000000000001111
11111111111110000000000000111111
11111111111100000000000011111111