11111111111111111111111111111111
11111111111111111111111111111111
11111111111111111111111111111111
11111111111111111111111111111111
11111111111111111111111111111111
11111111111111111111111111111111
11111111111111111111111111111111
11111111111110111111111111111111
00000000111110111333311111111111
00000000000110111333311111111111
00000000000110011333311111111111
00000000000110000333111111111111
00000000000000000000110000001111
11100000000000001000000000001111
11100000000000000000000011111111
11110000000000000001111111111111
11011000000000000001111111111111
11111000000000000000111111111111