11111111100000000000000000000000
11111111111100000000000000000000
11111111111111110000000000000000
11111111111111111000000000000000
11111111111111111000000000000000
11111111111111110000000000000000
11111111111111111100000000000000
11111111111111111110000000000000
11111111111111111111100000000000
11111111111111110011100000000000
11111111111111100000000000000000
11111111111111111000000000000000
11111111111111111110000000000000
11111111111111111111100000000000
11111111111111111111111100000000
11111111111111111111111110000000
11111111111111111111111000000000
11111111111111111111100000000000