00000000001111111111111111111111
00000000001111111111111111111111
00000000001111111111111111111111
00000000000111111111111111111111
00000000000011001111111111111111
11111000000000000000000001111111
11111000000000000000000000000000
00000000000000000000000000000000
00000000000000000011000000000000
00000000000000001111111110000000
00000000000000001111111111000000
00000000000000001111111000000000
00000000000000000000000000000000
00000000000000000000000000110000
00000000000000000000000000110000
00000000000000000000000000000000
00000000000011111111000000000000
00000000000111111111000000000000