11111111111111110000000000000000
11111111111111000000000000000000
11111111111111100000000000000000
11111111111111111100000000000000
11111111111111110000000000000000
11111111111110000000000000000000
11111111110000000000000000000000
11000010000000000011110000000000
00000000000000011111111000000000
00000000000111111111111111111111
00000000000000000011111111111111
00000000000000000011111111111111
00000000000000000011111111111111
00000000000000000011111111111111
00000000000000000001111111111111
00000000000000000111111111111111
00000000000000000000000011111111
00000000000000000000000000111111