00001111111100000000000000001111
00011111000000000000000000001111
00000000000000000000000000111111
00000000000000000000000011110111
00000000000000000000000011000001
00000000000000000000000000000000
00000000000000000000000000000000
00000000000000000000000000000001
00000111111110110000000000000111
00001111111111111110000000000111
11111111111111111110000000000111
11111111111110000000000000000000
11111111111000000000000000000000
11111111111110000001111111111111
11111111111111111111111111111111
11111111111111111111111111111111
11111111111111111111111111111111
11111111111111111111111111111111