00111000000000000000000000000000
00111000000000000000000000000000
00111000000000000000000000000000
00000000000000000000000000000000
00000000000000000011110011111110
00000000000000001111111111111111
00000000000000111111111111111111
11111000000001111111111111111111
11111000000011111111111111111111
11100000000000000111111111111111
10000000000000000111111111111111
00011000000000001111111111111111
01111111000000001111111111111111
11111111111000011111111111111111
11111111111111111111111111111111
11111111111111111111111111111111
11111111111111111111111111111111
11111111111111111111111111111111