11111110000000000000000000000000
11111110000000000000000000000000
00000000000000000000000000000000
00000000000000000000000000011111
00000000000011111111111111111111
11000000000011111111111111111111
11100001000000011111111111222221
11111111100000000111111111222221
11111111111000000000000000222221
11111111111111000000000000000220
11111111111110000000000000000000
11111100001111000000000000000000
11111000001111000000000000000000
11111000001111000000000111110000
11111000000000000000000111110000
11111000000000000000000000111111
11111111100000000000000000111101
11111111111000000000000000111111