11111000000000000000011111111111
11111111000000000000011111111111
11111111000000000000000111111111
11111100000000000000000001111111
11111000111000000000000000011111
11111111111000000000000000011111
11111100000000000000000000011111
11111000000000000000000000001111
11100000000000000000010000011111
00000000000000000000011000001111
00000000000000000000011000000011
00000000000000000000111110000000
01111000000000011111111111000000
11110000000000011111111111110000
11100000000000011111111111111110
11100000000001111111111111111111
11100000000111111111111111111111
11100000000001111111111111111111