11100000000000000000000011111111
11111000000000000000000001111111
11111110000000000000000001111111
11111111110000000001111111111111
11111111110000001111111111111111
11111111000000001111111111111111
11111100000000001111111111111111
11110000000000011111111111111111
11000000000000111111111111111111
11000000000000000011111111111111
11000000000000000000000001111111
01111000000000000000000000001111
00001110000000000000000000000111
00000011000000000000000000001111
00000000000000000000000001111111
00000000000111000000000011111111
00000000000001111000000001111111
00000000000000001110000000011111