11111111111110000000000000111111
11111111111110000000000000111111
11111111111111100000000000111111
11111111111111100000000000000111
11111111111111111000000000000011
11111111111111111000000000000000
11111111111111100000000000000000
11111111111111100000000000000000
11111111111111100000000000000000
11111111111111110000000000000000
11111111111111110000001110000000
11111111111110000000001111100000
11111111111110000000000111100000
11111111110000000000000000000000
11111111111000000000000000000011
11111111111111000000001000000111
11111111111111000000111111000111
11111111111111000000111111100111